%%%%%%%%%%%%%%%%%%%
%G.       G   ....%
%.% % %%%%%% %.%%.%
%.%o% %   o% %.o%.%
%.%%%.%  %%% %..%.%
%.....  P    %..% %
%%%%%%%%%%%%%%%%%%%%
