%%%%%%
%....%
% %%.%
% %%.%
%.P .%
%.%%%%
%G...%
%%%%%%