%%%%%%%%%%%%%%%%%%%%%%%%%%%%%%%%%%%%%%
%                                   P%
% %%%%%%%%%%%%%%%%%%% %%%  %%%%%%%%  %
% %%   %   %      %%% %%%    %% G    %
% %% % % % % %%%% %%%%%%%%%  %%  %%%%%
% %% % % % % %    %%         %%      %
% %% % % % % % %%%%%  %%%    %%%%%%  %
% %% % % %   %    %%  %%%%%%%%%      % 
% %% % % %%%%%%%% %%         %%  %%%%%
% %% %   %%       %%%%%%%%%  %%      %
%    %%% %% %%%%%%%      %%  %%%%%%  %
%%%%%%      %       %    %%  %%      %
%      %%%%%% %%   %%    %%  %%  %%%%%
% %%%%%%      %       %%%%%  %%      %
%          %%%%       %%%%%  %%%%%%  %
%%%%%%%%   %                 %%%%%%  %
%.         %%%%%%%%%%%%%%%%          %
%%%%%%%%%%%%%%%%%%%%%%%%%%%%%%%%%%%%%%