%%%%%%%%%%%%%%%%%%%%%%%%%%%%%%%%%%%%
% .                               P%
% %%%%%%%%%%%%%%%%%%%%%%% %%%%%%%% %
% %%   %   %       %%%%%%%   %%    %
% %% % % % % %%%% %%%%%%%%% %% %%%%%
% %% % % % %             %% %%     %
% %% % % % % % %%%%  %%%    %%%%%% %
% %  % % %   %    %% %%%%%%%%      % 
% %% % % %%%%%%%% %%        %% %%%%%
% %% %   %%       %%%%%%%%% %%     %
%    %%%%%% %%%%%%%      %% %%%%%% %
%%%%%%      %       %%%% %% %      %
%   G  %%%%%% %%%%% %    %% %% %%%%%
% %%%%%%      %       %%%%% %%   . %
%        %%%%%% %%%%%%%%%%% %%  %% %
%%%%%%%%%%                  %%%%%% %
%          %%%%%%%%%%%%%%%%     .  %
%%%%%%%%%%%%%%%%%%%%%%%%%%%%%%%%%%%%