%%%%%%%%%%%%%%%%%%%%%%%%%%%%%%%
%G...........%%%%%............%
%%%.%...%%%.........%.%...%.%%%
%...%%%.%.%%%%.%.%%%%%%.%%%...%
%.%.....%......%......%.....%.%
%.%%%.%%%%%.%%%%%%%.%%%.%.%%%%%
%.....%........P....%...%.....%
%%%%%%%%%%%%%%%%%%%%%%%%%%%%%%%
