%%%%%%%%%%%%%%%%%%%%%%%%%%%%%%%%%%%%
%   .                           . P%
% %%%%%%%%%%%%%%%%%%% %%% %%%%%%%% %
% %%   %   %  ..  %%% %%%   %% ... %
% %% % % % % %%%% %%%%%%%%% %% %%%%%
% %% % % % % %    %%     %% %% ... %
% %% % % % % % %%%%  %%%    %%%%%% %
% %  % % %   %    %% %%%%%%%%    . %
% %% % % %%%%%%%% %%        %% %%%%%
% %% %   %%       %%%%%%%%% %% .   %
%    %%%%%% %%%%%%%      %% %%%%%% %
%%%%%%      %       %%%% %% %  . . %
% G    %%%%%% %%%%% %    %% %% %%%%%
% %%%%%%      %       %%%%% %%     %
%        %%%%%% %%%%%%%%%%% %%  %% %
%%%%%%%%%%                  %%%%%% %
%.         %%%%%%%%%%%%%%%% ...... %
%%%%%%%%%%%%%%%%%%%%%%%%%%%%%%%%%%%%