%%%%%%%%%
%.P    G% 
% %.% %%%
%     %%%
%%%%%%%%%
