%%%%%%%%%%%%%%%%%%%%
%...%.........%%...%
%.%.%.%%%%%%%%%%.%.%
%..G...............%
%%%%%%%%.%.%%%%%%%P%
%%%%%%%%.......    %
%%%%%%%%%%%%%%%%%%%%
