%%%%%%%%%%%%%%%%%%%%
%..................%
%..................%
%........P.........%
%...G..............%
%..................%
%%%%%%%%%%%%%%%%%%%%
