%%%%%%%%%%%%%%%%%%%%
%.                .%
%        G         %
%                  %
%                  %
%.       P        .%
%%%%%%%%%%%%%%%%%%%%
