%%%%%%%%%%%%%%%%%%%%
%.  G        ...P .%
%.%%.%%.%%.%%.%% %.%
% %% %.....      %.%
%%%%%%%%%%%%%%%%%%%%
