%%%%%%%%%%%%%%%%%%%%
%.     %.  .%     .%
% %%   %%G %%   %% %
% %o %.      .% o% %
% %% % %%%%%% % %% %
%.       P        .%
%%%%%%%%%%%%%%%%%%%%
