%%%%%%%%%%%%%%%%%%%%
%.     %    %     .%
% %    %oG o%    % %
% %  %        %  % %
% %  % %%%%%% %  % %
%.       P        .%
%%%%%%%%%%%%%%%%%%%%
