%%%%%
%.P %
%%% %
%. G%
%%%%%
