%%%%%%%
%  ..P%
% %%%.%
%..%..%
%%   %%
%. G%%%
%%%%%%%