%%%%%%%
%   .P%
% %%% %
% G%  %
%% . %%
%. %%%%
%%%%%%%
