%%%%%%%
%    P%
% %%% %
%. % G%
%% . %%
% .%%%%
%%%%%%%
