%%%%%%%%%
%..   ..%
%%%%.%% %
%   P   %
%.%% %%.%
%.%.   G%
%%%%%%%%%
