%%%%%%%
%    P%
% %%% %
%..%.G%
%% . %%
%.  %%%
%%%%%%%