%%%%%%%%
%   P  %
%G%%%%%%
%....  %
%%%%%%%%
