%%%%%%%%%%%%%%%%%%%%
%.           ..%   %
%.%%.%%.%%.%%.%% % %
%        P       % %
%%%%%%%%%%%%%%%%%% %
%.....    G        %
%%%%%%%%%%%%%%%%%%%%
